30 30
00 00 00 00 00 16 12 12 12 12 12 12 12 12 12 12 12 12 12 12 12 12 12 12 14 00 00 00 00 00
00 00 00 00 00 11 00 00 00 00 00 00 00 00 00 00 00 00 00 00 03 00 00 00 11 00 00 00 00 00
00 00 00 00 00 11 00 17 00 00 00 00 00 00 08 06 00 00 00 00 04 00 00 00 11 00 00 00 00 00
00 00 00 00 00 11 00 00 00 00 00 00 00 00 09 07 00 00 00 00 05 00 00 00 11 00 17 00 00 00
00 00 00 00 00 11 00 00 00 00 00 00 00 00 00 00 00 00 00 00 05 00 00 00 11 00 00 00 00 00
00 00 00 00 00 11 00 18 00 00 00 00 00 00 00 00 00 00 00 00 04 00 00 00 11 00 00 00 00 00
16 12 12 12 12 13 02 01 02 02 01 02 01 02 00 00 00 00 00 00 05 00 00 00 15 12 12 12 12 14
11 00 00 00 00 03 10 10 00 00 00 00 00 00 00 00 00 00 00 00 03 00 00 10 00 00 00 00 00 11
11 00 17 00 00 03 00 00 00 00 00 00 00 00 00 00 00 00 00 00 03 00 00 00 00 00 00 00 00 11
11 00 00 00 00 04 00 00 00 00 00 00 00 00 00 00 00 00 00 00 04 00 00 00 00 00 00 00 00 11
11 00 00 00 00 03 00 00 00 00 00 00 00 00 00 00 00 00 00 00 03 00 00 00 00 00 00 00 00 11
11 00 00 00 00 04 00 00 00 00 00 00 00 00 00 00 00 00 00 00 05 00 00 00 00 00 00 00 00 11
11 00 00 00 00 04 00 00 00 00 00 00 00 00 00 00 00 00 00 00 04 00 00 00 00 00 00 00 00 11
11 00 00 00 00 03 00 00 00 00 00 00 00 00 00 00 00 00 00 00 05 00 00 00 00 00 00 00 00 11
11 00 00 00 00 05 00 00 00 00 00 00 00 00 00 00 00 00 00 00 03 00 00 00 00 00 00 00 00 11
11 00 17 00 00 05 00 00 00 00 00 00 00 00 00 00 00 00 00 00 04 00 00 00 00 10 00 00 00 11
11 00 00 00 00 03 00 00 00 00 00 00 00 00 00 00 00 00 00 00 05 19 00 00 00 00 00 00 00 11
11 00 00 00 00 05 00 00 00 00 00 00 00 00 00 00 00 00 00 00 04 00 00 00 00 00 00 00 00 11
11 00 00 00 00 04 00 00 00 00 00 00 00 00 00 00 00 00 00 00 05 00 00 00 00 00 00 00 00 11
11 00 00 00 00 03 00 00 00 00 00 00 00 00 00 00 00 00 00 00 05 00 00 00 00 00 00 00 00 11
11 00 00 00 00 05 00 00 00 00 00 00 00 00 00 00 00 00 00 00 03 00 00 00 00 00 00 00 00 11
11 00 00 00 00 04 00 00 00 00 00 00 00 00 00 00 00 00 00 00 05 00 00 00 00 00 00 00 00 11
11 00 00 00 00 09 06 00 00 00 00 00 00 00 00 00 00 00 00 00 00 00 00 00 00 00 00 00 00 11
15 12 12 12 12 14 09 02 01 01 02 01 02 02 02 01 01 02 01 01 02 02 01 01 16 12 12 12 12 13
00 00 00 00 00 11 00 00 00 00 00 00 00 10 00 00 00 00 00 00 04 00 00 00 11 00 00 00 00 00
00 00 00 00 00 11 00 00 00 00 00 00 00 00 00 00 00 00 00 17 05 00 00 00 11 00 00 00 00 00
00 00 00 00 00 11 17 00 00 00 00 17 00 00 00 00 00 00 00 00 04 00 00 00 11 00 00 00 00 00
00 00 00 00 00 11 00 00 00 00 00 00 00 00 00 00 00 00 00 00 03 10 00 00 11 00 00 00 00 00
00 00 00 00 00 11 00 00 00 00 00 00 00 17 00 00 00 00 00 00 05 00 00 00 11 00 00 00 00 00
00 00 00 00 00 15 12 12 12 12 12 12 12 12 12 12 12 12 12 12 12 12 12 12 13 00 00 00 00 00