30 30
17 17 00 10 00 16 12 12 12 12 12 12 12 12 12 12 12 12 12 12 12 12 12 12 14 10 00 00 00 10
00 10 00 00 00 11 10 00 00 00 00 00 00 00 00 00 00 00 00 00 00 00 00 00 11 00 17 00 00 00
00 00 17 00 10 11 00 00 00 00 00 00 00 08 02 01 06 00 00 10 00 00 00 00 11 00 17 00 10 00
00 17 00 00 00 11 00 00 00 00 00 00 00 05 00 00 03 00 00 00 00 00 10 00 11 00 17 00 00 00
00 00 00 00 00 11 00 00 00 10 00 00 00 09 02 02 07 00 00 00 00 00 00 00 11 00 00 10 00 00
00 00 00 17 00 11 00 00 00 00 00 00 00 00 00 00 00 00 00 00 00 00 00 00 11 00 00 00 00 10
16 12 12 12 12 13 00 00 00 00 00 10 00 00 00 00 00 00 00 00 00 00 00 00 15 12 12 12 12 14
11 00 00 00 00 00 00 00 00 00 00 00 00 00 00 00 10 00 00 00 00 00 10 00 00 00 00 00 00 11
11 00 00 00 00 00 00 00 00 16 12 14 00 00 00 00 00 00 16 12 14 00 00 00 00 00 00 10 00 11
11 00 00 00 10 00 00 00 00 11 19 15 12 12 12 12 12 12 13 19 11 00 00 00 00 17 00 00 00 11
11 10 00 00 00 00 00 00 00 15 14 00 00 00 00 00 00 00 00 16 13 00 00 00 17 17 10 00 00 11
11 00 00 00 00 00 00 00 00 00 11 00 16 12 12 12 12 14 00 11 00 00 00 00 00 00 00 00 00 11
11 00 16 12 12 17 12 17 14 00 11 00 11 00 00 00 00 11 00 11 00 17 17 17 17 17 17 17 00 11
11 00 11 00 00 00 00 00 11 00 11 00 11 00 16 14 00 11 00 11 00 17 00 00 00 17 00 17 00 11
11 00 11 00 00 00 00 17 00 00 11 00 11 00 11 11 00 11 00 11 00 00 17 17 00 00 00 17 00 11
11 00 00 17 00 00 00 00 11 00 11 00 11 00 11 11 00 11 00 11 00 17 00 00 17 00 17 00 00 11
11 00 11 00 00 00 00 00 11 00 11 00 11 00 15 13 00 11 00 11 00 18 00 17 17 00 00 17 00 11
11 00 15 12 12 12 12 12 13 00 11 00 11 00 00 00 00 11 00 11 00 17 17 00 00 18 17 17 00 11
11 00 00 00 00 00 00 00 00 00 11 00 15 12 12 12 12 13 00 11 00 00 10 00 00 00 00 00 00 11
11 00 00 00 00 00 00 00 00 16 13 00 00 00 00 00 00 00 00 15 14 00 00 00 00 17 00 00 00 11
11 00 00 00 00 10 00 10 00 11 19 16 12 12 12 12 12 12 14 19 11 00 00 00 00 00 00 00 00 11
11 00 00 00 00 00 00 00 00 15 12 13 00 10 00 00 00 00 15 12 13 00 00 00 00 00 00 17 00 11
11 00 10 00 00 00 00 00 00 00 00 00 00 00 00 00 00 00 00 00 00 00 00 00 00 00 00 17 17 11
15 12 12 12 12 14 00 00 00 00 00 00 00 00 00 00 00 00 00 00 00 10 00 00 16 12 12 12 12 13
00 00 10 00 00 11 00 00 00 00 00 00 16 12 12 12 00 14 00 00 00 00 17 00 11 00 00 00 00 17
17 00 00 00 00 11 00 10 10 00 00 00 11 00 00 18 00 11 00 00 00 00 00 00 11 00 00 00 00 17
00 00 10 00 00 11 00 00 00 00 00 00 11 00 00 00 00 11 00 00 00 10 00 00 11 00 00 00 00 17
00 10 00 00 00 11 00 17 00 00 00 00 15 12 12 12 12 13 00 10 00 00 00 00 11 00 00 00 00 11
00 00 00 17 00 11 00 00 00 00 00 00 00 00 00 00 00 00 00 00 00 00 00 00 11 00 00 00 00 11
10 00 00 10 00 15 12 12 12 12 12 12 12 12 12 12 12 12 12 12 12 12 12 12 13 00 12 17 00 17