30 30
16 12 12 12 12 12 14 17 12 00 12 12 00 12 17 00 12 17 16 12 12 12 12 12 12 12 12 12 12 14
11 00 00 03 00 00 11 00 17 00 00 00 17 00 00 00 00 00 11 00 00 00 00 00 00 00 00 00 00 11
11 00 00 04 00 00 11 17 17 00 17 00 17 00 17 17 17 00 11 00 00 00 00 00 00 00 00 00 00 11
11 00 00 04 00 10 11 00 00 17 00 17 00 17 17 00 00 17 11 00 00 00 00 00 00 00 17 00 00 11
11 10 00 05 10 00 11 00 00 00 17 00 00 00 00 00 17 00 11 00 00 00 00 00 00 00 00 00 00 11
11 00 10 04 00 00 11 00 00 00 00 00 00 00 00 00 00 00 11 00 00 00 00 00 00 00 00 00 00 11
11 10 00 03 10 10 11 00 00 00 10 10 10 00 00 00 00 00 11 00 00 00 00 00 00 00 00 00 00 11
11 00 00 05 18 00 11 10 00 00 10 00 10 00 00 00 00 00 11 17 17 00 00 10 00 00 00 00 17 11
11 00 10 05 00 00 11 00 00 00 10 10 10 00 10 00 00 00 11 17 17 17 00 00 00 00 00 17 17 11
11 00 00 04 00 00 11 00 00 00 00 00 00 00 00 00 00 00 11 17 17 17 17 00 17 17 17 17 17 11
11 00 00 03 00 00 11 00 00 00 00 00 00 00 00 10 00 00 11 17 17 17 00 00 00 00 00 17 17 11
11 00 00 05 00 00 11 10 00 10 00 00 00 10 00 00 00 00 11 17 00 00 00 00 00 00 00 00 17 11
11 00 00 03 00 10 11 00 00 00 00 10 00 00 00 00 10 00 11 00 00 00 00 00 00 00 00 00 17 11
11 00 00 03 00 00 11 00 10 00 00 00 10 00 00 10 00 00 11 00 00 00 00 03 00 00 00 00 00 11
11 00 00 03 00 00 11 00 00 00 10 00 00 00 00 00 00 00 11 00 00 00 00 04 00 00 00 00 00 11
11 00 17 05 00 00 11 00 10 00 00 10 00 00 00 00 10 00 11 00 00 00 00 03 00 10 00 00 00 11
11 00 00 05 00 00 11 00 00 00 00 00 00 00 00 00 00 00 11 00 00 19 00 05 00 00 00 00 00 11
11 00 00 04 00 00 11 00 00 10 10 18 00 00 00 10 00 00 11 00 00 00 00 04 00 00 00 00 00 11
11 00 00 04 00 00 11 00 10 00 00 00 00 10 00 00 00 00 11 00 00 00 00 04 00 00 00 00 00 11
11 00 00 03 00 00 11 00 00 00 10 00 10 00 00 00 00 00 11 00 00 00 00 04 00 00 00 00 00 11
11 00 00 05 00 00 11 00 00 00 00 00 00 17 00 00 00 00 11 00 00 00 00 05 00 00 00 00 00 11
11 00 00 03 00 00 15 12 12 17 12 12 17 00 12 00 12 12 13 00 00 00 00 05 00 00 00 00 00 11
11 00 00 04 00 00 00 00 00 00 00 00 00 00 00 00 00 00 00 00 00 00 00 05 00 00 00 00 00 11
11 00 00 05 00 00 00 00 00 00 00 00 00 00 00 00 00 00 00 00 00 00 00 03 00 00 00 00 00 11
11 00 00 03 00 00 00 00 00 18 00 00 00 10 00 00 00 00 00 00 00 00 00 03 00 00 00 00 00 11
11 00 00 09 01 02 01 02 02 02 01 01 01 02 01 01 02 02 01 01 01 02 02 07 00 00 00 00 00 11
11 00 00 00 00 00 17 00 00 00 00 17 00 00 00 00 00 00 00 00 00 00 00 00 00 00 00 00 00 11
11 00 00 00 00 00 00 00 00 00 00 00 00 00 00 00 00 00 00 00 00 10 00 00 00 00 00 00 00 11
11 00 00 00 00 00 00 00 00 00 00 00 00 17 00 00 00 00 00 00 00 00 00 00 00 00 00 00 00 11
15 12 12 12 12 12 12 12 12 12 12 12 12 12 12 12 12 12 12 12 12 12 12 12 12 12 12 12 12 13